..........................................................
..........................................................
.............................||||||||||||||||||||||||||||F
.............................|............................
.............................|............................
.............................|............................
.............................|............................
.............................|............................
.............................|............................
.............................|............................
............||||||||||||||||||............................
............|.............................................
............|.............................................
............|.............................................
............|.............................................
............|.............................................
............|.............................................
............|.............................................
....|||||||||.............................................
....|.....................................................
....|.....................................................
....|.....................................................
....|.....................................................
....C.....................................................
